19 19 19 19 19 19 19 19 19 19 19 19 19 19 19 19 19 19 19 19 19 19 19 19 19 19 19 19 19 19 19 19 19 19 19 19 19 19 19 19 19 19 19 19 19 19 19 19 19 19 
19 19 19 19 19 19 19 19 19 19 19 19 19 19 19 19 19 19 19 19 19 19 19 19 19 19 19 19 19 19 19 19 19 19 19 19 19 19 19 19 19 19 19 19 19 19 19 19 19 19 
19 19 19 19 19 19 19 19 19 19 19 19 19 19 19 19 19 19 19 19 19 19 19 19 19 19 19 19 19 19 19 19 19 19 19 19 19 19 19 19 19 19 19 19 19 19 19 19 19 19 
19 19 19 19 19 19 19 19 19 19 19 19 19 19 19 19 19 19 19 19 19 19 19 19 19 19 19 19 19 19 19 19 19 19 19 19 19 19 19 19 19 19 19 19 19 19 19 19 19 19 
19 19 19 19 19 19 19 19 19 19 19 19 19 19 19 19 19 19 19 19 19 19 19 19 19 19 19 19 19 19 19 19 19 19 19 19 19 19 19 19 19 19 19 19 19 19 19 19 19 19 
19 19 19 19 19 19 19 19 19 19 19 19 19 19 19 19 19 19 19 19 19 19 19 19 19 19 19 19 19 19 19 19 19 19 19 19 19 19 19 19 19 19 19 19 19 19 19 19 19 19 
19 19 19 19 19 19 19 19 28 26 26 26 26 26 26 26 29 19 19 19 19 19 19 19 19 19 19 29 19 19 19 19 26 26 26 26 26 26 26 26 26 26 29 19 19 19 19 19 19 19 
19 19 19 19 19 19 19 19 24 16 32 32 32 32 32 16 25 26 27 16 1 1 1 1 1 1 1 25 26 26 26 27 16 1 12 10 10 10 10 10 10 13 23 19 19 19 19 19 19 19 
19 19 19 19 19 19 19 19 24 16 32 17 17 17 32 16 16 16 16 16 1 20 21 21 21 22 1 16 16 16 16 16 16 16 8 3 3 3 3 3 3 7 23 19 19 19 19 19 19 19 
19 19 19 19 19 19 19 19 24 16 32 17 36 17 32 16 16 16 16 16 1 23 19 19 19 24 1 16 16 16 16 16 16 16 8 3 3 3 3 3 3 7 23 19 19 19 19 19 19 19 
19 19 19 19 19 19 19 19 24 16 32 17 17 17 32 16 16 16 16 16 1 23 19 19 19 24 1 16 16 16 16 16 16 16 8 3 3 3 3 3 3 7 23 19 19 19 19 19 19 19 
19 19 19 19 19 19 19 19 24 16 32 17 17 17 32 16 16 16 16 16 1 25 26 26 26 27 1 16 16 16 16 16 16 16 8 3 3 3 3 3 3 7 23 19 19 19 19 19 19 19 
19 19 19 19 19 19 19 19 24 16 32 32 17 32 32 16 16 16 16 16 1 1 12 10 13 1 1 1 1 1 1 1 1 1 14 5 5 6 3 4 5 15 23 19 19 19 19 19 19 19 
19 19 19 19 19 19 19 19 24 16 16 16 1 16 16 16 16 16 16 16 16 16 8 3 3 3 3 3 3 3 3 3 3 3 3 3 3 3 3 7 20 21 31 19 19 19 19 19 19 19 
19 19 19 19 19 19 19 19 19 22 16 16 1 16 16 16 16 16 16 16 16 16 8 3 7 16 16 16 16 16 16 16 16 16 16 16 16 8 3 7 23 19 19 19 19 19 19 19 19 19 
19 19 19 19 19 19 19 19 19 24 16 16 1 16 16 16 16 16 16 16 16 18 8 3 7 16 16 16 16 16 16 16 16 16 16 16 16 8 3 7 23 19 19 19 19 19 19 19 19 19 
19 19 19 19 19 19 19 19 28 27 16 16 1 16 16 16 16 16 16 16 16 18 8 3 7 1 1 1 16 16 16 16 16 16 16 16 16 8 3 7 23 19 19 19 19 19 19 19 19 19 
19 19 19 19 19 19 19 28 27 16 16 16 1 16 16 16 16 16 16 16 16 18 8 3 7 16 16 16 16 16 16 16 16 16 16 12 10 11 3 7 23 19 19 19 19 19 19 19 19 19 
19 19 19 19 19 19 19 24 16 16 3 1 1 16 16 16 16 16 16 16 16 18 8 3 7 16 16 16 16 16 16 16 16 16 16 8 3 3 3 7 23 19 19 19 19 19 19 19 19 19 
19 19 19 19 19 19 19 24 16 16 3 16 16 16 16 16 16 16 16 16 16 1 8 3 7 1 16 16 16 16 16 16 16 16 16 8 3 4 5 15 23 19 19 19 19 19 19 19 19 19 
19 19 19 19 19 19 19 24 16 16 3 16 16 1 12 10 10 10 10 10 10 10 11 3 9 10 10 10 10 13 16 16 16 12 10 11 3 7 1 16 23 19 19 19 19 19 19 19 19 19 
19 19 19 19 19 19 19 24 16 16 3 16 16 1 8 3 3 3 3 3 3 3 3 3 3 3 3 3 3 7 1 1 1 8 3 3 3 7 1 20 31 19 19 19 19 19 19 19 19 19 
19 19 19 19 19 19 19 24 16 16 3 16 16 1 14 5 5 5 5 5 5 5 6 3 4 5 5 5 5 15 16 16 16 14 5 6 3 7 2 23 19 19 19 19 19 19 19 19 19 19 
19 19 19 19 19 19 19 30 22 16 3 16 16 1 16 16 16 16 16 16 16 1 8 3 7 1 16 16 16 16 16 16 16 16 16 8 3 7 1 23 19 19 19 19 19 19 19 19 19 19 
19 19 19 19 19 19 19 19 24 16 3 16 16 1 16 16 16 16 16 16 16 16 8 3 7 16 16 16 16 16 16 16 16 16 16 8 3 7 1 23 19 19 19 19 19 19 19 19 19 19 
19 19 19 19 19 19 19 19 27 16 3 16 16 1 3 16 16 16 16 16 16 16 8 3 7 16 16 16 16 16 16 16 16 16 16 8 3 7 1 23 19 19 19 19 19 19 19 19 19 19 
19 19 19 19 19 19 19 24 16 16 3 16 16 16 3 16 16 16 16 16 16 16 8 3 7 16 16 16 16 16 16 16 16 16 16 8 3 7 1 23 19 19 19 19 19 19 19 19 19 19 
19 19 19 19 19 19 19 24 16 16 3 16 16 16 3 16 16 16 16 16 16 16 8 3 7 1 1 1 16 16 16 16 16 16 16 8 3 7 1 23 19 19 19 19 19 19 19 19 19 19 
19 19 19 19 19 19 19 24 16 16 3 16 16 16 3 16 16 16 16 16 16 16 8 3 7 16 16 1 16 16 16 16 16 16 16 8 3 7 1 23 19 19 19 19 19 19 19 19 19 19 
19 19 19 19 19 19 19 24 16 16 3 3 3 3 3 3 16 16 16 16 16 16 8 3 7 16 16 1 16 16 1 16 16 16 16 14 3 15 1 23 19 19 19 19 19 19 19 19 19 19 
19 19 19 19 19 19 19 24 16 16 3 3 3 3 3 3 16 16 16 16 16 16 8 3 7 16 16 1 16 16 1 16 16 16 16 16 3 16 20 19 19 19 19 19 19 19 19 19 19 19 
19 19 19 19 19 19 19 30 22 16 3 1 1 1 3 3 16 16 16 16 16 16 8 3 7 16 16 1 1 1 1 16 16 16 16 16 3 1 23 19 19 19 19 19 19 19 19 19 19 19 
19 19 19 19 19 19 19 19 24 16 3 1 1 2 1 3 16 16 16 16 16 16 8 3 7 1 16 16 16 16 16 16 16 16 16 1 3 1 23 19 19 19 19 19 19 19 19 19 19 19 
19 19 19 19 19 19 19 19 24 16 3 1 1 1 1 3 16 16 16 16 16 16 8 3 7 1 16 18 18 18 18 18 16 16 16 1 3 2 23 19 19 19 19 19 19 19 19 19 19 19 
19 19 19 19 19 19 19 19 24 16 3 3 3 3 3 3 16 16 16 16 16 16 8 3 7 1 16 18 18 18 18 18 16 16 16 1 3 1 23 19 19 19 19 19 19 19 19 19 19 19 
19 19 19 19 19 19 19 19 27 16 16 16 3 16 16 16 16 16 16 16 16 16 14 3 3 1 16 16 18 18 18 18 18 16 16 1 3 1 25 29 19 19 19 19 19 19 19 19 19 19 
19 19 19 19 19 19 19 19 16 16 16 16 3 16 16 16 16 16 16 16 1 1 1 3 3 18 18 16 16 16 16 18 18 16 1 1 3 1 1 25 29 19 19 19 19 19 19 19 19 19 
19 19 19 19 19 19 19 24 16 16 16 16 3 16 16 16 16 16 16 1 1 1 1 3 3 1 18 18 16 16 1 16 16 1 1 2 3 3 3 3 23 19 19 19 19 19 19 19 19 19 
19 19 19 19 19 19 19 24 16 16 16 16 3 16 16 16 16 16 16 1 1 1 1 3 3 1 18 18 16 16 16 16 1 1 3 3 3 3 3 3 23 19 19 19 19 19 19 19 19 19 
19 19 19 19 19 19 19 24 16 16 33 16 3 16 16 16 16 16 16 1 1 1 1 3 3 1 18 18 1 16 16 16 1 3 3 3 3 1 3 3 23 19 19 19 19 19 19 19 19 19 
19 19 19 19 19 19 19 24 16 16 3 3 3 3 3 3 3 3 3 3 3 3 3 3 3 3 3 3 3 3 3 3 3 3 16 3 1 18 18 3 23 19 19 19 19 19 19 19 19 19 
19 19 19 19 19 19 19 24 16 16 3 3 3 3 16 20 21 21 22 1 1 1 1 1 1 1 1 20 21 21 22 3 3 3 3 3 1 18 18 3 23 19 19 19 19 19 19 19 19 19 
19 19 19 19 19 19 19 24 16 16 16 16 16 16 20 31 19 19 30 22 1 1 1 1 1 1 20 31 19 19 24 3 3 16 3 3 16 3 3 3 23 19 19 19 19 19 19 19 19 19 
19 19 19 19 19 19 19 19 21 21 21 21 21 21 31 19 19 19 19 30 21 21 21 21 21 21 31 19 19 19 30 22 3 3 3 3 3 3 20 21 31 19 19 19 19 19 19 19 19 19 
19 19 19 19 19 19 19 19 19 19 19 19 19 19 19 19 19 19 19 19 19 19 19 19 19 19 19 19 19 19 19 30 21 21 21 21 21 21 31 19 19 19 19 19 19 19 19 19 19 19 
19 19 19 19 19 19 19 19 19 19 19 19 19 19 19 19 19 19 19 19 19 19 19 19 19 19 19 19 19 19 19 19 19 19 19 19 19 19 19 19 19 19 19 19 19 19 19 19 19 19 
19 19 19 19 19 19 19 19 19 19 19 19 19 19 19 19 19 19 19 19 19 19 19 19 19 19 19 19 19 19 19 19 19 19 19 19 19 19 19 19 19 19 19 19 19 19 19 19 19 19 
19 19 19 19 19 19 19 19 19 19 19 19 19 19 19 19 19 19 19 19 19 19 19 19 19 19 19 19 19 19 19 19 19 19 19 19 19 19 19 19 19 19 19 19 19 19 19 19 19 19 
19 19 19 19 19 19 19 19 19 19 19 19 19 19 19 19 19 19 19 19 19 19 19 19 19 19 19 19 19 19 19 19 19 19 19 19 19 19 19 19 19 19 19 19 19 19 19 19 19 19 
19 19 19 19 19 19 19 19 19 19 19 19 19 19 19 19 19 19 19 19 19 19 19 19 19 19 19 19 19 19 19 19 19 19 19 19 19 19 19 19 19 19 19 19 19 19 19 19 19 19 
