19 19 19 19 19 19 19 19 19 19 19 19 19 19 19 19 19 19 19 19 19 19 19 19 19 19 19 19 19 19 19 19 19 19 19 19 19 19 19 19 19 19 19 19 19 19 19 19 19 19 
19 19 19 19 19 19 19 19 19 19 19 19 19 19 19 19 19 19 19 19 19 19 19 19 19 19 19 19 19 19 19 19 19 19 19 19 19 19 19 19 19 19 19 19 19 19 19 19 19 19 
19 19 19 19 19 19 19 19 19 19 19 19 19 19 19 19 19 19 19 19 19 19 19 19 19 19 19 19 19 19 19 19 19 19 19 19 19 19 19 19 19 19 19 19 19 19 19 19 19 19 
19 19 19 19 19 19 19 19 19 19 19 19 19 19 19 19 19 19 19 19 19 19 19 19 19 19 19 19 19 19 19 19 19 19 19 19 19 19 19 19 19 19 19 19 19 19 19 19 19 19 
19 19 19 19 19 19 19 19 19 19 19 19 19 19 19 19 19 19 19 19 19 19 19 19 19 19 19 19 19 19 19 19 19 19 19 19 19 19 19 19 19 19 19 19 19 19 19 19 19 19 
19 19 19 19 19 19 19 19 19 19 19 19 19 19 19 19 19 19 19 19 19 19 19 19 19 19 19 19 19 19 19 19 19 19 19 19 19 19 19 19 19 19 19 19 19 19 19 19 19 19 
19 19 19 19 19 19 19 19 28 26 26 26 26 26 26 26 29 19 19 19 19 19 19 19 19 19 19 29 19 19 19 19 26 26 26 26 26 26 26 26 26 26 29 19 19 19 19 19 19 19 
19 19 19 19 19 19 19 19 24 16 32 32 32 32 32 16 25 26 27 16 1 1 1 1 1 1 1 25 26 26 26 27 2 2 12 10 10 10 10 10 10 13 23 19 19 19 19 19 19 19 
19 19 19 19 19 19 19 19 24 16 32 17 17 17 32 39 39 39 39 39 1 20 21 21 21 22 1 39 39 39 39 39 2 2 8 3 3 3 3 3 3 7 23 19 19 19 19 19 19 19 
19 19 19 19 19 19 19 19 24 16 32 17 36 17 32 39 39 18 39 39 1 23 19 19 19 24 1 39 39 18 18 39 39 39 8 3 3 3 3 3 3 7 23 19 19 19 19 19 19 19 
19 19 19 19 19 19 19 19 24 16 32 17 17 17 32 18 18 1 1 1 1 23 19 19 19 24 1 39 39 18 18 39 39 39 8 3 3 3 3 3 3 7 23 19 19 19 19 19 19 19 
19 19 19 19 19 19 19 19 24 16 32 17 17 17 32 18 1 1 1 1 1 25 26 26 26 27 1 39 39 39 39 39 39 39 8 3 3 3 3 3 3 7 23 19 19 19 19 19 19 19 
19 19 19 19 19 19 19 19 24 16 32 32 17 32 32 10 10 10 10 10 1 1 12 10 13 1 1 1 1 1 1 1 1 1 14 5 5 6 3 4 5 15 23 19 19 19 19 19 19 19 
19 19 19 19 19 19 19 19 24 16 16 16 3 3 3 3 3 3 3 3 7 18 8 3 3 3 3 3 3 3 3 3 3 3 3 3 3 3 3 7 20 21 31 19 19 19 19 19 19 19 
19 19 19 19 19 19 19 19 19 22 16 39 39 39 39 39 39 39 39 3 7 18 8 3 7 18 16 16 16 40 41 16 16 16 16 16 16 8 3 7 23 19 19 19 19 19 19 19 19 19 
19 19 19 19 19 19 19 19 19 19 22 1 1 1 1 1 20 21 21 3 7 18 8 3 7 18 16 16 16 42 43 16 16 16 16 16 16 8 3 7 23 19 19 19 19 19 19 19 19 19 
19 19 19 19 19 19 19 19 28 19 19 21 21 21 21 21 19 19 19 3 7 18 8 3 7 18 18 40 41 44 45 40 41 40 41 16 16 8 3 7 23 19 19 19 19 19 19 19 19 19 
19 19 19 19 19 19 19 19 19 19 19 26 26 26 26 26 26 26 26 3 7 18 8 3 7 18 18 42 43 40 41 42 43 42 43 12 10 11 3 7 23 19 19 19 19 19 19 19 19 19 
19 19 19 19 19 19 19 19 26 26 27 2 2 2 2 2 2 2 2 3 7 18 8 3 7 18 18 44 45 42 43 44 45 44 45 8 3 3 3 7 23 19 19 19 19 19 19 19 19 19 
19 19 19 19 19 19 19 24 18 18 2 2 2 2 2 2 2 2 8 3 7 1 8 3 7 1 39 39 39 44 45 39 39 39 39 8 3 4 5 15 23 19 19 19 19 19 19 19 19 19 
19 19 19 19 19 19 19 24 18 8 3 7 1 1 1 18 18 18 8 3 9 10 11 3 9 10 10 1 1 39 39 39 39 12 10 11 3 7 1 16 23 19 19 19 19 19 19 19 19 19 
19 19 19 19 19 19 19 24 18 8 3 7 1 1 1 18 40 41 3 3 3 3 3 3 3 3 3 1 1 39 39 39 39 8 3 3 3 7 1 20 31 19 19 19 19 19 19 19 19 19 
19 19 19 19 19 19 19 24 18 8 3 7 1 1 1 18 42 43 5 5 5 5 6 3 4 5 5 39 39 39 39 39 39 14 5 6 3 7 2 23 19 19 19 19 19 19 19 19 19 19 
19 19 19 19 19 19 19 30 22 8 3 7 1 1 16 16 44 45 39 39 39 39 8 3 7 1 1 1 1 39 39 39 39 39 39 8 3 7 1 23 19 19 19 19 19 19 19 19 19 19 
19 19 19 19 19 19 19 19 24 8 3 7 1 1 40 41 1 1 40 41 39 39 8 3 7 18 18 39 39 39 39 39 39 39 39 8 3 7 1 23 19 19 19 19 19 19 19 19 19 19 
19 19 19 19 19 19 19 19 27 8 3 7 1 39 42 43 40 41 42 43 39 39 8 3 7 18 18 39 39 39 39 39 39 39 39 8 3 7 1 23 19 19 19 19 19 19 19 19 19 19 
19 19 19 19 19 19 19 24 18 8 3 7 39 39 44 45 42 43 44 45 39 39 8 3 7 18 18 39 39 39 39 39 39 39 39 8 3 7 1 23 19 19 19 19 19 19 19 19 19 19 
19 19 19 19 19 19 19 24 18 8 3 7 39 39 39 39 44 45 39 39 39 39 8 3 7 20 22 1 39 39 39 39 39 39 39 8 3 7 1 23 19 19 19 19 19 19 19 19 19 19 
19 19 19 19 19 19 19 24 18 8 3 7 39 39 39 39 1 39 39 39 39 39 8 3 7 23 24 1 1 1 1 1 1 1 1 8 3 1 1 23 19 19 19 19 19 19 19 19 19 19 
19 19 19 19 19 19 19 19 21 22 3 7 2 2 1 21 21 21 21 21 21 21 46 47 48 19 19 21 21 21 21 21 21 21 22 8 3 20 21 19 19 19 19 19 19 19 19 19 19 19 
19 19 19 19 19 19 19 19 19 24 3 7 2 2 1 19 19 19 19 19 19 19 49 50 51 19 19 19 19 19 19 19 19 19 24 8 3 23 19 19 19 19 19 19 19 19 19 19 19 19 
19 19 19 19 19 19 19 19 19 27 3 7 2 2 1 19 19 19 19 19 19 19 49 50 51 19 19 19 19 19 19 19 19 19 24 8 3 23 19 19 19 19 19 19 19 19 19 19 19 19 
19 19 19 19 19 19 19 19 24 16 3 7 2 2 1 26 26 26 26 26 26 26 52 53 54 26 26 26 26 26 26 26 26 26 27 1 3 1 23 19 19 19 19 19 19 19 19 19 19 19 
19 19 19 19 19 19 19 19 24 16 3 3 3 1 1 39 39 39 39 39 39 39 8 3 7 1 39 39 39 39 39 39 39 39 39 1 3 2 23 19 19 19 19 19 19 19 19 19 19 19 
19 19 19 19 19 19 19 19 24 16 3 3 3 39 39 39 39 39 39 39 39 39 8 3 7 1 39 18 18 18 18 18 16 16 16 1 3 1 23 19 19 19 19 19 19 19 19 19 19 19 
19 19 19 19 19 19 19 19 27 16 16 16 3 16 16 16 1 16 16 16 16 16 8 3 7 18 39 39 18 18 18 18 18 16 16 1 3 1 25 29 19 19 19 19 19 19 19 19 19 19 
19 19 19 19 19 19 19 19 16 16 16 16 3 16 16 16 1 1 1 1 1 1 8 3 7 18 18 39 39 39 39 18 18 16 1 1 3 1 1 25 29 19 19 19 19 19 19 19 19 19 
19 19 19 19 19 19 19 24 16 16 16 16 3 16 16 16 16 16 16 1 1 1 8 3 9 10 10 10 10 10 10 10 10 10 10 10 3 2 2 2 23 19 19 19 19 19 19 19 19 19 
19 19 19 19 19 19 19 24 16 16 16 16 3 16 16 16 16 16 16 1 3 3 3 3 3 3 3 3 3 3 3 3 3 3 3 3 3 2 2 2 23 19 19 19 19 19 19 19 19 19 
19 19 19 19 19 19 19 24 16 16 33 16 3 16 16 16 16 16 16 1 1 1 1 5 5 5 5 5 5 5 5 5 5 5 5 5 5 1 2 2 23 19 19 19 19 19 19 19 19 19 
19 19 19 19 19 19 19 24 16 16 3 3 3 3 3 3 3 3 3 3 3 3 2 2 2 2 2 2 2 2 2 2 2 2 16 2 1 18 18 2 23 19 19 19 19 19 19 19 19 19 
19 19 19 19 19 19 19 24 16 16 3 3 3 3 16 20 21 21 22 2 2 2 2 2 2 2 2 20 21 21 22 2 2 2 2 2 1 18 18 2 23 19 19 19 19 19 19 19 19 19 
19 19 19 19 19 19 19 24 16 16 16 16 16 16 20 31 19 19 30 22 2 2 2 18 18 2 20 31 19 19 24 2 2 16 2 2 16 2 2 2 23 19 19 19 19 19 19 19 19 19 
19 19 19 19 19 19 19 19 21 21 21 21 21 21 31 19 19 19 19 30 21 21 21 21 21 21 31 19 19 19 30 22 2 2 2 2 2 2 20 21 31 19 19 19 19 19 19 19 19 19 
19 19 19 19 19 19 19 19 19 19 19 19 19 19 19 19 19 19 19 19 19 19 19 19 19 19 19 19 19 19 19 30 21 21 21 21 21 21 31 19 19 19 19 19 19 19 19 19 19 19 
19 19 19 19 19 19 19 19 19 19 19 19 19 19 19 19 19 19 19 19 19 19 19 19 19 19 19 19 19 19 19 19 19 19 19 19 19 19 19 19 19 19 19 19 19 19 19 19 19 19 
19 19 19 19 19 19 19 19 19 19 19 19 19 19 19 19 19 19 19 19 19 19 19 19 19 19 19 19 19 19 19 19 19 19 19 19 19 19 19 19 19 19 19 19 19 19 19 19 19 19 
19 19 19 19 19 19 19 19 19 19 19 19 19 19 19 19 19 19 19 19 19 19 19 19 19 19 19 19 19 19 19 19 19 19 19 19 19 19 19 19 19 19 19 19 19 19 19 19 19 19 
19 19 19 19 19 19 19 19 19 19 19 19 19 19 19 19 19 19 19 19 19 19 19 19 19 19 19 19 19 19 19 19 19 19 19 19 19 19 19 19 19 19 19 19 19 19 19 19 19 19 
19 19 19 19 19 19 19 19 19 19 19 19 19 19 19 19 19 19 19 19 19 19 19 19 19 19 19 19 19 19 19 19 19 19 19 19 19 19 19 19 19 19 19 19 19 19 19 19 19 19 
