0 0 0 0 0 0 0 0 0 0 0 0 0 0 0 0 0 0 0 0 0 0 0 0 0 0 0 0 0 0 0 0 0 0 0 0 0 0 0 0 0 0 0 0 0 0 0 0 0 0 
0 0 0 0 0 0 0 0 0 0 0 0 0 0 0 0 0 0 0 0 0 0 0 0 0 0 0 0 0 0 0 0 0 0 0 0 0 0 0 0 0 0 0 0 0 0 0 0 0 0 
0 0 0 0 0 0 0 0 0 0 0 0 0 0 0 0 0 0 0 0 0 0 0 0 0 0 0 0 0 0 0 0 0 0 0 0 0 0 0 0 0 0 0 0 0 0 0 0 0 0 
0 0 0 0 0 0 0 0 0 0 0 0 0 0 0 0 0 0 0 0 0 0 0 0 0 0 0 0 0 0 0 0 0 0 0 0 0 0 0 0 0 0 0 0 0 0 0 0 0 0 
0 0 0 0 0 0 0 0 0 0 0 0 0 0 0 0 0 0 0 0 0 0 0 0 0 0 0 0 0 0 0 0 0 0 0 0 0 0 0 0 0 0 0 0 0 0 0 0 0 0 
0 0 0 0 0 0 0 0 0 0 0 0 0 0 0 0 0 0 0 0 0 0 0 0 0 0 0 0 0 0 0 0 0 0 0 0 0 0 0 0 0 0 0 0 0 0 0 0 0 0 
0 0 0 0 0 0 0 32 32 32 32 32 32 32 32 32 32 32 32 32 32 32 32 32 32 32 32 32 32 32 32 32 32 32 32 32 32 32 32 32 32 32 32 0 0 0 0 0 0 0 
0 0 0 0 0 0 0 32 17 17 32 32 32 17 17 17 17 17 17 32 32 32 32 32 32 32 32 32 32 32 32 32 32 32 32 32 32 32 32 32 32 32 32 0 0 0 0 0 0 0 
0 0 0 0 0 0 0 32 17 17 32 32 17 17 17 17 17 17 17 32 32 32 32 32 32 32 32 32 32 32 32 17 17 17 17 17 17 32 32 32 32 32 32 0 0 0 0 0 0 0 
0 0 0 0 0 0 0 32 32 17 17 17 17 17 17 17 17 17 17 17 17 17 17 17 17 17 17 17 17 32 17 17 17 17 32 32 17 32 32 32 32 32 32 0 0 0 0 0 0 0 
0 0 0 0 0 0 0 32 32 17 17 17 17 17 17 17 17 17 17 17 17 17 17 17 17 17 17 17 17 17 17 17 17 32 32 32 17 17 32 32 32 32 32 0 0 0 0 0 0 0 
0 0 0 0 0 0 0 32 32 17 17 17 17 17 17 17 17 17 17 17 17 17 17 17 17 17 17 17 17 17 17 17 32 32 32 32 17 32 32 32 32 32 32 0 0 0 0 0 0 0 
0 0 0 0 0 0 0 32 32 17 17 17 17 17 17 17 17 17 17 17 17 17 17 17 17 17 17 17 17 17 32 32 32 32 32 32 17 32 32 32 17 32 32 0 0 0 0 0 0 0 
0 0 0 0 0 0 0 32 32 17 17 17 17 17 17 17 17 17 17 17 17 17 17 17 17 17 17 17 32 32 32 32 32 32 32 32 17 17 32 17 17 17 17 0 0 0 0 0 0 0 
0 0 0 0 0 0 0 32 32 17 17 17 17 17 17 17 17 17 17 17 17 17 17 17 17 17 17 17 32 32 32 32 32 32 32 32 17 17 17 17 32 32 17 0 0 0 0 0 0 0 
0 0 0 0 0 0 0 32 32 17 17 17 17 17 17 17 17 17 17 17 17 17 17 17 17 17 17 32 32 32 32 32 32 32 32 17 17 17 17 17 17 32 17 0 0 0 0 0 0 0 
0 0 0 0 0 0 0 32 17 17 32 17 17 17 17 17 17 17 17 17 17 17 17 17 17 17 32 32 32 32 32 32 32 32 32 32 17 17 17 17 17 17 17 0 0 0 0 0 0 0 
0 0 0 0 0 0 0 32 17 17 32 32 17 17 17 17 17 17 17 17 17 17 17 17 17 17 32 32 32 32 32 32 32 32 32 17 17 17 17 17 17 32 32 0 0 0 0 0 0 0 
0 0 0 0 0 0 0 32 17 17 17 17 17 32 32 32 32 32 32 32 32 32 32 32 32 17 17 17 17 17 17 17 17 17 17 17 17 17 17 17 17 17 32 0 0 0 0 0 0 0 
0 0 0 0 0 0 0 32 17 17 17 17 17 32 32 32 32 32 17 32 32 32 32 32 32 17 17 17 17 17 32 32 32 32 32 32 17 17 17 17 17 32 32 0 0 0 0 0 0 0 
0 0 0 0 0 0 0 32 17 17 17 17 17 32 32 32 32 32 17 17 17 32 32 32 32 17 17 17 17 32 32 32 32 32 32 32 32 32 17 32 32 32 32 0 0 0 0 0 0 0 
0 0 0 0 0 0 0 32 17 17 17 17 17 32 32 32 32 32 17 17 17 32 32 32 32 32 17 17 17 32 32 32 32 32 32 32 32 32 17 32 32 32 32 0 0 0 0 0 0 0 
0 0 0 0 0 0 0 32 32 32 17 32 32 32 32 32 32 32 17 17 17 32 32 32 32 32 32 32 17 17 17 32 32 32 32 32 32 32 17 32 32 32 32 0 0 0 0 0 0 0 
0 0 0 0 0 0 0 32 32 32 17 32 32 32 32 32 32 32 17 17 32 32 32 32 32 32 32 32 32 32 17 17 32 32 32 32 32 17 17 17 17 32 32 0 0 0 0 0 0 0 
0 0 0 0 0 0 0 32 32 32 17 32 32 32 17 17 17 32 17 17 32 32 32 32 32 32 32 32 32 32 32 17 17 32 32 32 32 32 32 17 17 32 32 0 0 0 0 0 0 0 
0 0 0 0 0 0 0 32 32 32 17 32 17 17 17 17 17 17 17 17 32 32 32 32 32 32 32 32 32 32 17 17 17 17 32 32 32 32 32 17 17 32 32 0 0 0 0 0 0 0 
0 0 0 0 0 0 0 32 32 32 17 17 17 17 17 17 17 17 17 17 32 17 17 17 32 32 32 32 32 32 17 17 17 32 17 32 32 32 32 17 17 32 32 0 0 0 0 0 0 0 
0 0 0 0 0 0 0 32 32 32 17 17 17 17 17 32 17 17 17 17 17 17 32 17 17 32 32 32 32 32 17 17 17 17 17 32 32 32 32 17 17 32 32 0 0 0 0 0 0 0 
0 0 0 0 0 0 0 32 32 32 32 32 17 17 17 17 17 17 17 32 32 32 32 32 17 17 32 32 32 32 32 32 32 32 32 32 32 32 32 17 17 32 32 0 0 0 0 0 0 0 
0 0 0 0 0 0 0 32 32 32 32 32 17 17 17 17 17 17 32 32 32 32 32 32 32 17 17 17 17 32 32 32 32 32 32 32 32 32 32 17 17 32 32 0 0 0 0 0 0 0 
0 0 0 0 0 0 0 32 32 32 32 32 32 17 17 17 17 32 32 32 32 32 32 32 17 17 17 17 17 32 32 32 32 32 32 32 32 32 17 17 17 32 32 0 0 0 0 0 0 0 
0 0 0 0 0 0 0 32 32 32 32 32 32 17 32 32 32 32 32 32 32 32 32 17 17 17 17 17 17 32 32 32 32 32 32 32 32 32 17 17 17 32 32 0 0 0 0 0 0 0 
0 0 0 0 0 0 0 32 32 32 32 32 17 17 32 32 32 32 32 32 32 32 17 17 32 17 17 17 17 32 32 32 32 32 32 32 32 32 17 17 17 32 32 0 0 0 0 0 0 0 
0 0 0 0 0 0 0 32 32 32 32 32 17 32 32 32 32 32 32 32 32 32 17 17 32 17 17 17 32 32 32 32 32 32 32 32 32 32 32 17 17 32 32 0 0 0 0 0 0 0 
0 0 0 0 0 0 0 32 32 32 17 17 17 32 32 32 32 32 32 32 32 32 17 17 32 32 32 32 32 32 32 32 32 32 32 17 17 32 32 17 17 32 32 0 0 0 0 0 0 0 
0 0 0 0 0 0 0 32 17 17 17 32 32 32 32 32 32 32 32 32 32 32 17 17 32 32 32 32 32 32 32 32 32 32 17 17 32 32 32 17 17 32 32 0 0 0 0 0 0 0 
0 0 0 0 0 0 0 32 32 32 32 32 32 32 32 32 32 32 32 32 32 17 17 17 32 32 32 32 32 32 32 32 32 17 17 32 32 32 32 17 17 32 32 0 0 0 0 0 0 0 
0 0 0 0 0 0 0 32 32 32 32 32 32 32 32 32 32 32 32 32 17 17 32 32 32 32 32 32 32 32 32 32 32 17 32 32 32 32 32 17 17 32 32 0 0 0 0 0 0 0 
0 0 0 0 0 0 0 32 32 32 32 32 32 32 32 32 32 32 32 32 17 17 32 32 32 32 32 32 32 32 32 32 32 17 32 32 32 32 32 17 17 32 32 0 0 0 0 0 0 0 
0 0 0 0 0 0 0 32 32 32 32 32 32 32 32 32 32 32 32 32 17 17 32 32 32 32 32 32 32 32 32 32 32 17 32 32 32 32 32 17 17 32 32 0 0 0 0 0 0 0 
0 0 0 0 0 0 0 32 17 17 17 32 32 32 32 32 32 32 32 32 17 17 32 32 32 32 32 32 32 32 32 32 32 17 32 32 32 32 32 17 17 32 32 0 0 0 0 0 0 0 
0 0 0 0 0 0 0 32 17 37 17 17 17 17 17 17 17 17 17 17 17 17 17 17 17 17 17 17 17 17 17 17 17 17 17 17 17 17 17 17 17 32 32 0 0 0 0 0 0 0 
0 0 0 0 0 0 0 32 17 17 17 32 32 32 32 32 32 32 32 32 32 32 32 32 32 32 32 32 32 32 32 32 32 32 32 32 32 32 32 32 32 32 32 0 0 0 0 0 0 0 
0 0 0 0 0 0 0 32 32 32 32 32 32 32 32 32 32 32 32 32 32 32 32 32 32 32 32 32 32 32 32 32 32 32 32 32 32 32 32 32 32 32 32 0 0 0 0 0 0 0 
0 0 0 0 0 0 0 0 0 0 0 0 0 0 0 0 0 0 0 0 0 0 0 0 0 0 0 0 0 0 0 0 0 0 0 0 0 0 0 0 0 0 0 0 0 0 0 0 0 0 
0 0 0 0 0 0 0 0 0 0 0 0 0 0 0 0 0 0 0 0 0 0 0 0 0 0 0 0 0 0 0 0 0 0 0 0 0 0 0 0 0 0 0 0 0 0 0 0 0 0 
0 0 0 0 0 0 0 0 0 0 0 0 0 0 0 0 0 0 0 0 0 0 0 0 0 0 0 0 0 0 0 0 0 0 0 0 0 0 0 0 0 0 0 0 0 0 0 0 0 0 
0 0 0 0 0 0 0 0 0 0 0 0 0 0 0 0 0 0 0 0 0 0 0 0 0 0 0 0 0 0 0 0 0 0 0 0 0 0 0 0 0 0 0 0 0 0 0 0 0 0 
0 0 0 0 0 0 0 0 0 0 0 0 0 0 0 0 0 0 0 0 0 0 0 0 0 0 0 0 0 0 0 0 0 0 0 0 0 0 0 0 0 0 0 0 0 0 0 0 0 0 
0 0 0 0 0 0 0 0 0 0 0 0 0 0 0 0 0 0 0 0 0 0 0 0 0 0 0 0 0 0 0 0 0 0 0 0 0 0 0 0 0 0 0 0 0 0 0 0 0 0 
