19 19 19 19 19 19 19 19 19 19 19 19 19 19 19 19 19 19 19 19 19 19 19 19 19 19 19 19 19 19 19 19 19 19 19 19 19 19 19 19 19 19 19 19 19 19 19 19 19 19 
19 19 19 19 19 19 19 19 19 19 19 19 19 19 19 19 19 19 19 19 19 19 19 19 19 19 19 19 19 19 19 19 19 19 19 19 19 19 19 19 19 19 19 19 19 19 19 19 19 19 
19 19 19 19 19 19 19 19 19 19 19 19 19 19 19 19 19 19 19 19 19 19 19 19 19 19 19 19 19 19 19 19 19 19 19 19 19 19 19 19 19 19 19 19 19 19 19 19 19 19 
19 19 19 19 19 19 19 19 19 19 19 19 19 19 19 19 19 19 19 19 19 19 19 19 19 19 19 19 19 19 19 19 19 19 19 19 19 19 19 19 19 19 19 19 19 19 19 19 19 19 
19 19 19 19 19 19 19 19 19 19 19 19 19 19 19 19 19 19 19 19 19 19 19 19 19 19 19 19 19 19 19 19 19 19 19 19 19 19 19 19 19 19 19 19 19 19 19 19 19 19 
19 19 19 19 19 19 19 19 19 19 19 19 19 19 19 19 19 19 19 19 19 19 19 19 19 19 19 19 19 19 19 19 19 19 19 19 19 19 19 19 19 19 19 19 19 19 19 19 19 19 
19 19 19 19 19 19 19 19 28 26 26 26 26 26 26 26 29 19 28 26 26 26 26 26 26 26 26 29 19 19 19 28 26 26 26 26 26 26 26 26 26 26 29 19 19 19 19 19 19 19 
19 19 19 19 19 19 19 19 24 16 32 32 32 32 32 39 25 26 27 39 1 1 1 1 1 1 1 25 26 26 26 27 2 12 10 10 10 10 10 10 10 13 23 19 19 19 19 19 19 19 
19 19 19 19 19 19 19 19 24 16 32 17 17 17 32 39 39 39 39 39 1 20 21 21 21 22 1 40 41 40 41 40 41 8 3 3 3 3 3 3 3 7 23 19 19 19 19 19 19 19 
19 19 19 19 19 19 19 19 24 16 32 17 36 17 32 39 39 39 39 39 1 23 19 19 19 24 1 42 43 42 43 42 43 8 3 3 3 3 3 3 3 7 23 19 19 19 19 19 19 19 
19 19 19 19 19 19 19 19 24 16 32 17 17 17 32 39 39 39 39 39 1 25 26 26 26 27 1 44 45 44 45 44 45 8 3 3 3 3 3 3 3 7 23 19 19 19 19 19 19 19 
19 19 19 19 19 19 19 19 24 16 32 17 17 17 32 39 39 39 39 39 1 1 1 1 2 12 10 10 10 10 10 10 10 11 3 3 3 3 3 3 3 7 23 19 19 19 19 19 19 19 
19 19 19 19 19 19 19 19 24 16 32 32 17 32 32 10 10 10 10 10 13 2 12 10 10 11 3 3 3 3 3 3 3 3 3 3 3 3 3 4 5 15 23 19 19 19 19 19 19 19 
19 19 19 19 19 19 19 19 24 16 16 8 3 3 3 3 3 3 3 3 7 18 8 3 3 3 3 3 3 3 3 3 3 3 3 3 3 3 3 7 20 21 31 19 19 19 19 19 19 19 
19 19 19 19 19 19 19 19 30 22 16 14 5 5 5 5 5 5 6 3 7 18 8 3 4 5 5 5 5 5 5 5 5 5 5 5 5 6 3 7 23 19 19 19 19 19 19 19 19 19 
19 19 19 19 19 19 19 19 19 30 22 1 1 1 1 1 20 22 8 3 7 18 8 3 7 1 1 1 39 39 39 39 39 39 39 16 16 8 3 7 23 19 19 19 19 19 19 19 19 19 
19 19 19 19 19 19 19 19 19 19 30 21 21 21 21 21 31 24 8 3 7 18 8 3 7 1 1 40 41 20 21 21 21 22 39 16 16 8 3 7 23 19 19 19 19 19 19 19 19 19 
19 19 19 19 19 19 19 19 19 19 28 26 26 26 26 26 26 27 8 3 7 18 8 3 7 1 1 42 43 23 19 19 19 24 39 12 10 11 3 7 23 19 19 19 19 19 19 19 19 19 
19 19 19 19 19 19 19 28 26 26 27 2 2 2 2 2 2 2 8 3 7 18 8 3 7 1 1 44 45 23 19 19 19 24 39 8 3 3 3 7 23 19 19 19 19 19 19 19 19 19 
19 19 19 19 19 19 19 24 39 39 2 2 2 2 2 2 2 2 8 3 7 18 8 3 7 1 1 1 39 25 26 29 28 27 39 8 3 4 5 15 23 19 19 19 19 19 19 19 19 19 
19 19 19 19 19 19 19 24 39 12 10 13 1 1 1 18 18 18 8 3 9 10 11 3 9 10 13 1 39 39 39 23 24 39 39 8 3 7 1 1 23 19 19 19 19 19 19 19 19 19 
19 19 19 19 19 19 19 24 39 8 3 7 1 1 1 18 40 41 8 3 3 3 3 3 3 3 7 1 1 40 41 23 24 39 39 8 3 7 1 20 31 19 19 19 19 19 19 19 19 19 
19 19 19 19 19 19 19 24 39 8 3 7 1 1 1 18 42 43 14 5 5 5 6 3 4 5 15 40 41 42 43 23 24 39 39 8 3 7 1 23 19 19 19 19 19 19 19 19 19 19 
19 19 19 19 19 19 19 30 22 8 3 7 1 1 1 39 44 45 39 39 39 18 8 3 7 1 1 42 43 44 45 23 24 39 39 8 3 7 1 23 19 19 19 19 19 19 19 19 19 19 
19 19 19 19 19 19 19 19 24 8 3 7 1 1 40 41 1 1 40 41 39 18 8 3 7 18 18 44 45 39 39 23 24 39 39 8 3 7 1 23 19 19 19 19 19 19 19 19 19 19 
19 19 19 19 19 19 19 28 27 8 3 7 1 39 42 43 40 41 42 43 39 18 8 3 7 18 18 39 39 40 41 23 24 39 39 8 3 7 1 23 19 19 19 19 19 19 19 19 19 19 
19 19 19 19 19 19 19 24 18 8 3 7 39 39 44 45 42 43 44 45 39 18 8 3 7 18 18 39 39 42 43 23 24 39 39 8 3 7 1 23 19 19 19 19 19 19 19 19 19 19 
19 19 19 19 19 19 19 24 18 8 3 7 39 39 39 39 44 45 39 39 39 18 8 3 7 1 1 1 39 44 45 25 27 39 39 8 3 7 1 23 19 19 19 19 19 19 19 19 19 19 
19 19 19 19 19 19 19 24 18 8 3 7 39 39 39 39 1 39 39 39 39 18 8 3 7 2 2 1 1 1 1 1 1 1 1 8 3 7 1 23 19 19 19 19 19 19 19 19 19 19 
19 19 19 19 19 19 19 30 22 8 3 7 2 18 1 20 21 21 21 21 21 22 8 3 7 20 21 21 21 21 21 21 21 21 22 8 3 7 20 31 19 19 19 19 19 19 19 19 19 19 
19 19 19 19 19 19 19 19 24 8 3 7 2 18 1 23 19 19 19 19 19 24 8 3 7 23 19 28 26 26 26 26 29 19 24 8 3 7 23 19 19 19 19 19 19 19 19 19 19 19 
19 19 19 19 19 19 19 19 24 8 3 7 2 18 1 23 19 19 19 19 19 24 8 3 7 23 19 24 18 18 18 18 23 19 24 8 3 7 23 19 19 19 19 19 19 19 19 19 19 19 
19 19 19 19 19 19 19 19 24 8 3 9 13 18 1 23 19 19 19 19 19 24 8 3 7 23 19 30 21 21 21 21 31 19 24 8 3 7 23 19 19 19 19 19 19 19 19 19 19 19 
19 19 19 19 19 19 19 19 24 8 3 3 7 1 1 23 19 19 19 19 19 24 8 3 7 23 19 19 19 19 19 19 19 19 24 8 3 7 23 19 19 19 19 19 19 19 19 19 19 19 
19 19 19 19 19 19 19 19 24 14 6 3 7 39 39 25 26 26 26 26 26 27 8 3 7 25 26 26 26 26 26 26 26 26 27 8 3 7 23 19 19 19 19 19 19 19 19 19 19 19 
19 19 19 19 19 19 19 28 27 16 8 3 9 10 13 2 2 2 2 2 2 2 8 3 7 1 1 18 18 18 18 18 1 16 16 8 3 7 25 29 19 19 19 19 19 19 19 19 19 19 
19 19 19 19 19 19 19 24 16 16 8 3 3 3 7 40 41 18 1 18 1 18 8 3 7 1 1 1 1 1 1 1 1 16 16 8 3 7 1 25 29 19 19 19 19 19 19 19 19 19 
19 19 19 19 19 19 19 24 16 16 14 5 6 3 7 42 43 18 1 18 1 18 8 3 9 10 10 10 10 10 10 10 10 10 10 11 3 7 1 1 23 19 19 19 19 19 19 19 19 19 
19 19 19 19 19 19 19 24 16 16 16 16 8 3 7 44 45 18 1 18 1 18 8 3 3 3 3 3 3 3 3 3 3 3 3 3 3 7 2 2 23 19 19 19 19 19 19 19 19 19 
19 19 19 19 19 19 19 24 16 16 33 16 8 3 9 10 10 10 10 10 10 10 11 3 4 5 5 5 5 5 5 5 5 5 5 5 5 15 2 2 23 19 19 19 19 19 19 19 19 19 
19 19 19 19 19 19 19 24 16 16 16 16 8 3 3 3 3 3 3 3 3 3 3 3 7 2 2 2 2 2 2 2 2 40 41 18 1 18 18 2 23 19 19 19 19 19 19 19 19 19 
19 19 19 19 19 19 19 24 16 16 16 16 14 5 5 5 5 5 5 5 5 5 5 5 2 2 2 20 21 21 22 2 2 42 43 18 1 18 18 2 23 19 19 19 19 19 19 19 19 19 
19 19 19 19 19 19 19 24 16 16 16 16 16 16 20 21 21 21 21 22 2 18 18 18 18 2 20 31 19 19 24 2 2 44 45 1 18 1 2 2 23 19 19 19 19 19 19 19 19 19 
19 19 19 19 19 19 19 30 21 21 21 21 21 21 31 19 19 19 19 30 21 21 21 21 21 21 31 19 19 19 30 22 2 2 2 2 2 2 20 21 31 19 19 19 19 19 19 19 19 19 
19 19 19 19 19 19 19 19 19 19 19 19 19 19 19 19 19 19 19 19 19 19 19 19 19 19 19 19 19 19 19 30 21 21 21 21 21 21 31 19 19 19 19 19 19 19 19 19 19 19 
19 19 19 19 19 19 19 19 19 19 19 19 19 19 19 19 19 19 19 19 19 19 19 19 19 19 19 19 19 19 19 19 19 19 19 19 19 19 19 19 19 19 19 19 19 19 19 19 19 19 
19 19 19 19 19 19 19 19 19 19 19 19 19 19 19 19 19 19 19 19 19 19 19 19 19 19 19 19 19 19 19 19 19 19 19 19 19 19 19 19 19 19 19 19 19 19 19 19 19 19 
19 19 19 19 19 19 19 19 19 19 19 19 19 19 19 19 19 19 19 19 19 19 19 19 19 19 19 19 19 19 19 19 19 19 19 19 19 19 19 19 19 19 19 19 19 19 19 19 19 19 
19 19 19 19 19 19 19 19 19 19 19 19 19 19 19 19 19 19 19 19 19 19 19 19 19 19 19 19 19 19 19 19 19 19 19 19 19 19 19 19 19 19 19 19 19 19 19 19 19 19 
19 19 19 19 19 19 19 19 19 19 19 19 19 19 19 19 19 19 19 19 19 19 19 19 19 19 19 19 19 19 19 19 19 19 19 19 19 19 19 19 19 19 19 19 19 19 19 19 19 19 
