19 19 19 19 19 19 19 19 19 19 19 19 19 19 19 19 19 19 19 19 19 19 19 19 19 19 19 19 19 19 19 19 19 19 19 19 19 19 19 19 19 19 19 19 19 19 19 19 19 19 
19 19 19 19 19 19 19 19 19 19 19 19 19 19 19 19 19 19 19 19 19 19 19 19 19 19 19 19 19 19 19 19 19 19 19 19 19 19 19 19 19 19 19 19 19 19 19 19 19 19 
19 19 19 19 19 19 19 19 19 19 19 19 19 19 19 19 19 19 19 19 19 19 19 19 19 19 19 19 19 19 19 19 19 19 19 19 19 19 19 19 19 19 19 19 19 19 19 19 19 19 
19 19 19 19 19 19 19 19 19 19 19 19 19 19 19 19 19 19 19 19 19 19 19 19 19 19 19 19 19 19 19 19 19 19 19 19 19 19 19 19 19 19 19 19 19 19 19 19 19 19 
19 19 19 19 19 19 19 19 19 19 19 19 19 19 19 19 19 19 19 19 19 19 19 19 19 19 19 19 19 19 19 19 19 19 19 19 19 19 19 19 19 19 19 19 19 19 19 19 19 19 
19 19 19 19 19 19 19 19 19 19 19 19 19 19 19 19 19 19 19 19 19 19 19 19 19 19 19 19 19 19 19 19 19 19 19 19 19 19 19 19 19 19 19 19 19 19 19 19 19 19 
19 19 19 19 19 19 19 19 28 26 26 26 26 26 26 26 29 19 28 26 26 26 26 26 26 26 26 29 19 19 19 28 26 26 26 26 26 26 26 26 26 26 29 19 19 19 19 19 19 19 
19 19 19 19 19 19 19 19 24 32 32 32 32 32 32 2 25 26 27 18 39 39 39 39 39 39 39 25 26 26 26 27 2 12 10 10 10 10 13 2 2 2 23 19 19 19 19 19 19 19 
19 19 19 19 19 19 19 19 24 32 32 32 0 0 32 2 16 18 16 18 39 20 21 21 21 22 39 18 18 40 41 18 18 8 3 3 3 3 7 55 56 57 23 19 19 19 19 19 19 19 
19 19 19 19 19 19 19 19 24 32 34 34 36 0 32 2 16 18 16 18 39 23 19 19 19 24 39 18 18 42 43 18 18 8 3 3 3 3 7 58 59 60 23 19 19 19 19 19 19 19 
19 19 19 19 19 19 19 19 24 32 34 32 32 32 32 2 16 18 16 18 39 25 26 26 26 27 39 18 18 44 45 18 18 8 3 3 3 3 9 10 13 2 23 19 19 19 19 19 19 19 
19 19 19 19 19 19 19 19 24 32 34 34 34 32 32 2 16 18 16 18 39 39 39 39 2 2 2 2 2 2 2 2 2 8 3 3 3 3 3 3 7 2 23 19 19 19 19 19 19 19 
19 19 19 19 19 19 19 19 24 32 32 32 34 32 32 10 10 10 10 10 13 2 12 10 10 10 10 10 10 10 10 10 10 11 3 3 3 3 3 4 15 2 23 19 19 19 19 19 19 19 
19 19 19 19 19 19 19 19 24 16 16 8 3 3 3 3 3 3 3 3 7 18 8 3 3 3 3 3 3 3 3 3 3 3 3 3 3 3 3 7 20 21 31 19 19 19 19 19 19 19 
19 19 19 19 19 19 19 19 30 22 16 14 5 5 5 5 5 5 6 3 7 18 8 3 4 5 5 5 5 5 5 5 5 5 5 5 5 6 3 7 23 19 19 19 19 19 19 19 19 19 
19 19 19 19 19 19 19 19 19 30 22 18 18 18 18 18 20 22 8 3 7 18 8 3 7 1 1 1 16 16 16 16 16 16 16 16 16 8 3 7 23 19 19 19 19 19 19 19 19 19 
19 19 19 19 19 19 19 19 19 19 30 21 21 21 21 21 31 24 8 3 7 18 8 3 7 1 1 1 1 20 21 21 21 22 16 16 16 8 3 7 23 19 19 19 19 19 19 19 19 19 
19 19 19 19 19 19 19 19 19 19 28 26 26 26 26 26 26 27 8 3 7 18 8 3 7 1 55 56 57 23 19 19 19 24 16 12 10 11 3 7 23 19 19 19 19 19 19 19 19 19 
19 19 19 19 19 19 19 28 26 26 27 2 2 2 2 2 2 2 8 3 7 18 8 3 7 1 58 59 60 23 19 19 19 24 16 8 3 3 3 7 23 19 19 19 19 19 19 19 19 19 
19 19 19 19 19 19 19 24 39 39 2 2 2 2 2 2 2 2 8 3 7 18 8 3 7 1 1 1 39 23 19 19 28 27 16 8 3 4 5 15 23 19 19 19 19 19 19 19 19 19 
19 19 19 19 19 19 19 24 39 12 10 10 10 13 1 18 18 18 8 3 9 10 11 3 9 10 13 1 39 23 19 19 24 39 39 8 3 7 1 1 23 19 19 19 19 19 19 19 19 19 
19 19 19 19 19 19 19 24 39 8 3 3 3 7 1 18 16 16 8 3 3 3 3 3 3 3 7 1 1 23 19 19 24 39 39 8 3 7 1 20 31 19 19 19 19 19 19 19 19 19 
19 19 19 19 19 19 19 24 39 8 3 3 3 7 18 18 16 16 14 5 5 5 6 3 4 5 15 1 1 23 19 19 24 39 39 8 3 7 1 23 19 19 19 19 19 19 19 19 19 19 
19 19 19 19 19 19 19 30 22 8 3 3 3 7 18 1 16 16 16 16 16 18 8 3 7 1 1 20 21 31 19 19 24 39 39 8 3 7 1 23 19 19 19 19 19 19 19 19 19 19 
19 19 19 19 19 19 19 19 24 8 3 3 3 7 1 1 16 16 16 16 16 18 8 3 7 18 18 23 19 19 19 19 24 39 39 8 3 7 1 23 19 19 19 19 19 19 19 19 19 19 
19 19 19 19 19 19 19 28 27 8 3 3 3 7 2 1 40 41 16 16 16 18 8 3 7 18 18 23 19 38 19 19 24 39 39 8 3 7 1 23 19 19 19 19 19 19 19 19 19 19 
19 19 19 19 19 19 19 24 18 8 3 3 3 7 2 2 42 43 16 16 16 18 8 3 7 18 18 23 19 19 19 19 24 39 39 8 3 7 1 23 19 19 19 19 19 19 19 19 19 19 
19 19 19 19 19 19 19 24 18 8 3 3 3 7 2 2 44 45 16 16 16 18 8 3 7 1 1 25 26 26 26 26 27 39 39 8 3 7 1 23 19 19 19 19 19 19 19 19 19 19 
19 19 19 19 19 19 19 24 18 8 3 3 3 7 2 2 2 2 2 2 2 18 14 5 15 2 2 1 1 1 1 1 1 1 1 8 3 7 1 23 19 19 19 19 19 19 19 19 19 19 
19 19 19 19 19 19 19 30 22 8 3 3 3 7 18 20 21 21 21 21 21 46 47 47 47 48 21 21 21 21 21 21 21 21 22 8 3 7 20 31 19 19 19 19 19 19 19 19 19 19 
19 19 19 19 19 19 19 19 24 8 3 3 3 7 18 23 19 19 19 19 19 49 50 50 50 51 19 28 26 26 26 26 29 19 24 8 3 7 23 19 19 19 19 19 19 19 19 19 19 19 
19 19 19 19 19 19 19 19 24 8 3 3 3 7 18 23 19 19 19 19 19 49 50 50 50 51 19 24 18 18 18 18 23 19 24 8 3 7 23 19 19 19 19 19 19 19 19 19 19 19 
19 19 19 19 19 19 19 19 24 8 3 3 3 7 18 23 19 19 38 19 19 49 50 50 50 51 19 30 21 21 21 21 31 19 24 8 3 7 23 19 19 19 19 19 19 19 19 19 19 19 
19 19 19 19 19 19 19 19 24 8 3 3 3 7 18 23 19 19 19 19 19 49 50 50 50 51 19 19 19 19 19 19 19 19 24 8 3 7 23 19 19 19 19 19 19 19 19 19 19 19 
19 19 19 19 19 19 19 19 24 14 6 3 3 7 18 25 26 26 26 26 26 52 53 53 53 54 26 26 26 26 26 26 26 26 27 8 3 7 23 19 19 19 19 19 19 19 19 19 19 19 
19 19 19 19 19 19 19 28 27 16 8 3 3 9 13 2 2 2 2 2 2 2 12 10 13 1 1 18 18 18 18 18 1 16 16 8 3 7 25 29 19 19 19 19 19 19 19 19 19 19 
19 19 19 19 19 19 19 24 16 16 14 5 6 3 7 40 41 18 1 18 1 18 8 3 7 1 1 1 1 1 1 1 1 16 16 8 3 7 1 25 29 19 19 19 19 19 19 19 19 19 
19 19 19 19 19 19 19 24 16 61 62 63 8 3 7 42 43 18 1 18 1 18 8 3 9 10 10 10 10 10 10 10 10 10 10 11 3 7 1 1 23 19 19 19 19 19 19 19 19 19 
19 19 19 19 19 19 19 24 16 64 65 66 8 3 7 44 45 18 1 18 1 18 8 3 3 3 3 3 3 3 3 3 3 3 3 3 3 7 2 2 23 19 19 19 19 19 19 19 19 19 
19 19 19 19 19 19 19 24 16 67 33 68 8 3 9 10 10 10 10 10 10 10 11 3 4 5 5 5 5 5 5 5 5 5 5 5 5 15 2 2 23 19 19 19 19 19 19 19 19 19 
19 19 19 19 19 19 19 24 16 16 2 2 8 3 3 3 3 3 3 3 3 3 3 3 7 2 2 2 2 2 2 2 2 40 41 18 1 18 2 2 23 19 19 19 19 19 19 19 19 19 
19 19 19 19 19 19 19 24 16 16 2 2 14 5 5 5 5 5 5 5 5 5 5 5 15 2 2 20 21 21 22 2 2 42 43 18 1 18 2 2 23 19 19 19 19 19 19 19 19 19 
19 19 19 19 19 19 19 24 16 16 16 16 16 16 20 21 21 21 21 22 2 18 18 18 18 2 20 31 19 19 24 2 2 44 45 1 18 1 2 2 23 19 19 19 19 19 19 19 19 19 
19 19 19 19 19 19 19 30 21 21 21 21 21 21 31 19 19 19 19 30 21 21 21 21 21 21 31 19 19 19 30 22 2 2 2 2 2 2 20 21 31 19 19 19 19 19 19 19 19 19 
19 19 19 19 19 19 19 19 19 19 19 19 19 19 19 19 19 19 19 19 19 19 19 19 19 19 19 19 19 19 19 30 21 21 21 21 21 21 31 19 19 19 19 19 19 19 19 19 19 19 
19 19 19 19 19 19 19 19 19 19 19 19 19 19 19 19 19 19 19 19 19 19 19 19 19 19 19 19 19 19 19 19 19 19 19 19 19 19 19 19 19 19 19 19 19 19 19 19 19 19 
19 19 19 19 19 19 19 19 19 19 19 19 19 19 19 19 19 19 19 19 19 19 19 19 19 19 19 19 19 19 19 19 19 19 19 19 19 19 19 19 19 19 19 19 19 19 19 19 19 19 
19 19 19 19 19 19 19 19 19 19 19 19 19 19 19 19 19 19 19 19 19 19 19 19 19 19 19 19 19 19 19 19 19 19 19 19 19 19 19 19 19 19 19 19 19 19 19 19 19 19 
19 19 19 19 19 19 19 19 19 19 19 19 19 19 19 19 19 19 19 19 19 19 19 19 19 19 19 19 19 19 19 19 19 19 19 19 19 19 19 19 19 19 19 19 19 19 19 19 19 19 
19 19 19 19 19 19 19 19 19 19 19 19 19 19 19 19 19 19 19 19 19 19 19 19 19 19 19 19 19 19 19 19 19 19 19 19 19 19 19 19 19 19 19 19 19 19 19 19 19 19 
